아이디		id
비번		passwd
이름		name
성별		gender
기숙사		dom
생년		age
학번		hakbun
단과		department
취침시간		sleep
기상시간		wake
샤워소요시간	showertime
샤워시간		whenshower
잠귀		sensitive
이갈이		jamb1
잠꼬대		jamb2
코골이		jamb2
수면등		sleeplight
알람		alarmhear
청소		clean
더위		heat
추위		cold
소리		soundgigi
흡연여부		smoking
실내통화		silnaecall
친구초대		friendinvite
기숙사식		eatbob
공부		studytype
향수		perfume
향민감도		smellwell
컴퓨터게임	game
야식		yasick
술		sool
실내취식		silnaeeat
벌레		insect